100010001000100010001000100010001000100010001000
000000000000000000000000
000010001000100010001000
000000000000000000000000
000010001000100010001000
000000000000000000000000
000010001000100010001000
000000000000000000000000
000010001000100010001000
000000000000000000000000
000010001000100010001000
000000000000000000000000
000010001000100010001000
000000000000000000000000
000010001000100010001000
000000000000000000000000
000010001000100010001000
000000000000000000000000
000010001000100010001000
000000000000000000000000
100010001000100010001000
000000000000000000000000